user: food an	 (bot: What part of town do you have in mind?)
user: any any part of town	 (bot: michaelhouse_cafe serves european food .)
user: im looking for a	 (bot: What part of town do you have in mind?)
user: derately priced	 (bot: What kind of food would you like?)
user: breath price range	 (bot: the_nirala is in the moderate price range)
user: food	 (bot: Can I help you with anything else?)
user: uh what is the	 (bot: kohinoor is a great restaurant serving indian food and it is in the cheap price range)
user: food	 (bot: royal_spice is a nice restaurant in the north of town in the cheap price range)
user: i want to find a rest	 (bot: What kind of food would you like?)
user: uh	 (bot: Can I help you with anything else?)
user: next	 (bot: Can I help you with anything else?)
user: and what area is it in	 (bot: cote is a nice place in the centre of town)
user: catalan food	 (bot: api_call R_cuisine south R_price)
user: how about portugeuse	 (bot: peking_restaurant is a nice restaurant in the south of town serving chinese food)
user: portugeuse	 (bot: nandos is a nice restaurant in the south of town serving portuguese food)
user: what is	 (bot: thanh_binh is a nice restaurant in the west of town in the cheap price range)
user: where is it lcoated	 (bot: You are looking for a restaurant is that right?)
user: is there	 (bot: I am sorry but there is no tuscan restaurant that matches your request)
user: dont want that	 (bot: la_tasca serves spanish food .)
user: is there any	 (bot: curry_prince is a nice restaurant in the east of town in the moderate price range)
user: thank you good	 (bot:  you are welcome)
user: i want a restaurant that serves	 (bot: Would you like something in the cheap , moderate , or expensive price range?)
user: what about earatree food	 (bot: la_mimosa serves mediterranean food .)
user: i want	 (bot: api_call R_cuisine R_location R_price)
user: hi i want a restaurant	 (bot: Would you like something in the cheap , moderate , or expensive price range?)
user: and whats their	 (bot: la_tasca serves spanish food .)
user: and what area is that	 (bot: la_tasca is a nice place in the centre of town)
user: good i have the address of that	 (bot: Sure , the_gardenia is on the_gardenia_address)
user: could i have its number	 (bot: thanh_binh is a nice restaurant in the west of town in the cheap price range)
user: where	 (bot: da_vinci_pizzeria is a great restaurant serving italian food and it is in the cheap price range)
user: no im looking	 (bot: yu_garden is in the east part of town .)
user: im looking	 (bot: Can I help you with anything else?)
user: what	 (bot: thanh_binh is a nice restaurant in the west of town in the cheap price range)
user: whats the address again	 (bot: Sure , thanh_binh is on thanh_binh_address)
user: food	 (bot: What kind of food would you like?)
user: thank you	 (bot:  you are welcome)
user: can i have the area of the restaurant	 (bot: saigon_city is a nice place in the north of town)
user: im looking for a restaurant in any area serving	 (bot: api_call R_cuisine R_location R_price)
user: serving catalan food	 (bot: I am sorry but there is no catalan restaurant that matches your request)
user: im looking for a restaurant serving venetian food	 (bot: api_call venetian R_location R_price)
user: im looking for a restaurant serving	 (bot: I am sorry but there is no venetian restaurant that matches your request)
user: whats their price range	 (bot: cambridge_lodge_restaurant is in the expensive price range)
user: im looking for	 (bot: What kind of food would you like?)
user: a restaurant	 (bot: api_call R_cuisine R_location R_price)
user: barbecue food	 (bot: api_call R_cuisine R_location cheap)
user: i want a restaurant in the we	 (bot: Would you like something in the cheap , moderate , or expensive price range?)
user: how about one serving jamaican food	 (bot: I am sorry but there is no jamaican restaurant that matches your request)
user: central inaudible	 (bot: You are looking for a restaurant is that right?)
user: any range	 (bot: api_call irish R_location R_price)
user: im looking	 (bot: api_call R_cuisine R_location R_price)
user: whats the type of food	 (bot: rajmahal is a nice restaurant in the east of town in the moderate price range)
user: address price range	 (bot: Sure , little_seoul is on little_seoul_address)
user: russian food	 (bot: api_call russian R_location moderate)
user: im looking for cross over food	 (bot: I am sorry but there is no crossover restaurant that matches your request)
user: i am looking for sweedish food	 (bot: I am sorry but there is no swedish restaurant that matches your request)
user: can i get the area	 (bot: la_raza serves spanish food .)
user: can i get the area	 (bot: la_raza is a nice place in the centre of town)
user: uh looking for a restaurant in any area and that needs to serve	 (bot: Would you like something in the cheap , moderate , or expensive price range?)
user: uh that doesnt matter	 (bot: api_call R_cuisine R_location R_price)
user: what part	 (bot: gourmet_burger_kitchen is a great restaurant)
user: im looking for a restaurant that serves	 (bot: What kind of food would you like?)
user: in the ea	 (bot: What kind of food would you like?)
user: ye	 (bot: Would you like something in the cheap , moderate , or expensive price range?)
user: can i get a restaurant	 (bot: What part of town do you have in mind?)
user: can i get the number	 (bot: Sure , sala_thong is on sala_thong_address)
user: can i	 (bot: mahal_of_cambridge is a great restaurant)
user: yeah i need um um m	 (bot: Would you like something in the cheap , moderate , or expensive price range?)
user: how bout asian	 (bot: gourmet_burger_kitchen is a nice restaurant in the centre of town serving north_american food)
user: i need asian how bout asian food	 (bot: gourmet_burger_kitchen is in the centre part of town .)
user: what kind of food is that	 (bot: gourmet_burger_kitchen serves north_american food)
user: thats great what else is there	 (bot: pizza_hut_cherry_hinton is a nice restaurant in the south of town in the moderate price range)
user: pan asian	 (bot: What kind of food would you like?)
user: pan asian	 (bot: api_call R_cuisine south R_price)
user: hi need an	 (bot: What part of town do you have in mind?)
user: thatll do dear whats the address of that venue	 (bot: Sure , meghna is on meghna_address)
user: and price range	 (bot: sala_thong is in the expensive price range)
user: right	 (bot: api_call R_cuisine R_location moderate)
user: breath what type of food is it	 (bot: the_lucky_star serves chinese food)
user: what about portugese	 (bot: nandos is a nice restaurant in the south of town serving portuguese food)
user: price does not matter	 (bot: You are looking for a restaurant is that right?)
user: yea	 (bot: Sorry there is no cheap restaurant in the north of town serving asian_oriental food)
user: what about cuban food	 (bot: Sorry there is no cheap restaurant in the north of town serving cuban food)
user: part of town	 (bot: What kind of food would you like?)
user: serving	 (bot: What part of town do you have in mind?)
user: anywhere	 (bot: api_call R_cuisine R_location moderate)
user: okay	 (bot: Can I help you with anything else?)
user: ostro asian	 (bot: I am sorry but there is no australasian restaurant that matches your request)
user: adress	 (bot: Sure , meghna is on meghna_address)
user: cant	 (bot: Would you like something in the cheap , moderate , or expensive price range?)
user: sea food	 (bot: api_call R_cuisine R_location R_price)
user: any type	 (bot: api_call R_cuisine east expensive)
user: cough	 (bot: What part of town do you have in mind?)
user: system	 (bot: What kind of food would you like?)
user: thank you	 (bot: Can I help you with anything else?)
user: what food is available	 (bot: the good luck chinese food takeaway is a nice restaurant in the south of town in the expensive price range)
user: thank you	 (bot: the good luck chinese food takeaway is a nice restaurant in the south of town in the expensive price range)
user: is there	 (bot: Sorry there is no moderate restaurant in the west of town serving romanian food)
user: what food is available in this area	 (bot: the_varsity_restaurant is a nice place in the centre of town)
user: what price range is this venue	 (bot: The post code of saigon_city is saigon_city_post_code)
user: what about the area	 (bot: saigon_city is a nice place in the north of town)
user: okay	 (bot: Can I help you with anything else?)
user: thank you	 (bot: la_margherita is a nice restaurant in the west of town in the cheap price range)
user: thank you have a good day	 (bot: chiquito_restaurant_bar is a nice restaurant in the south of town in the expensive price range)
user: venue	 (bot: da_vinci_pizzeria is a nice restaurant in the north of town in the cheap price range)
user: what type of venue	 (bot: da_vinci_pizzeria serves italian food)
user: cough	 (bot: What kind of food would you like?)
user: pan asian food	 (bot: Would you like something in the cheap , moderate , or expensive price range?)
user: pan asian	 (bot: prezzo is in the west part of town .)
user: im sorry	 (bot: What kind of food would you like?)
user: type of food they serve	 (bot: the_nirala serves indian food)
user: steakhouse	 (bot: What kind of food would you like?)
user: singapore food	 (bot: api_call R_cuisine R_location R_price)
user: the type of food	 (bot: golden_wok serves chinese food)
user: barbecue	 (bot: api_call R_cuisine R_location cheap)
user: moderat	 (bot: What kind of food would you like?)
user: what else do you have	 (bot: la_margherita is a nice restaurant in the west of town in the cheap price range)
user: i would like a	 (bot: You are looking for a restaurant is that right?)
user: whats the addre	 (bot: Sure , the cow pizza kitchen and bar is on the_cow_pizza_kitchen_and_bar_address)
user: the area	 (bot: the cow pizza kitchen and bar is a nice place in the centre of town)
user: adddress	 (bot: Sure , anatolia is on anatolia_address)
user: eritrean	 (bot: What kind of food would you like?)
user: er do they serve eritrean food	 (bot: The price range at royal_spice is cheap .)
user: does anyone serve eritrean food	 (bot: Can I help you with anything else?)
user: modern euorpean	 (bot: darrys_cookhouse_and_wine_shop is a nice restaurant in the centre of town serving modern_european food)
user: i want sea food	 (bot: loch_fyne is a great restaurant serving seafood food and it is in the expensive price range)
user: part of town is it in	 (bot: loch_fyne is a nice place in the centre of town)
user: whats their price range	 (bot: prezzo is in the moderate price range)
user: serves	 (bot: Would you like something in the cheap , moderate , or expensive price range?)
user: cannabis	 (bot: What kind of food would you like?)
user: cannabis	 (bot: api_call R_cuisine west R_price)
user: hello and welcome to the cambridge	 (bot: What kind of food would you like?)
user: the area	 (bot: Can I help you with anything else?)
user: where is the area	 (bot: thanh_binh serves vietnamese food .)
user: of the venue	 (bot: Can I help you with anything else?)
user: where is the area of the venue	 (bot: thanh_binh is a nice place in the west of town)
user: thank you	 (bot:  you are welcome)
user: restaurant in any area thats	 (bot: Would you like something in the cheap , moderate , or expensive price range?)
user: in appleton wiscon	 (bot: api_call R_cuisine R_location R_price)
user: thank you	 (bot: I am sorry but there is no irish restaurant that matches your request)
user: and what type of food	 (bot: la_margherita serves italian food)
user: are there any others	 (bot: api_call R_cuisine south expensive)
user: thank you	 (bot: frankie_and_bennys is a nice restaurant in the south of town in the expensive price range)
user: thank you good b	 (bot:  you are welcome)
user: i am looking for	 (bot: Would you like something in the cheap , moderate , or expensive price range?)
user: can i have the address phone number and	 (bot: The phone number of gourmet_burger_kitchen is gourmet_burger_kitchen_phone)
user: thank you	 (bot: gourmet_burger_kitchen is a great restaurant)
user: free	 (bot: Would you like something in the cheap , moderate , or expensive price range?)
user: scottish food	 (bot: I am sorry but there is no irish restaurant that matches your request)
user: scottish food	 (bot: I am sorry but there is no scottish restaurant that matches your request)
user: that doesnt matter	 (bot: api_call indian R_location R_price)
user: i need a restaurant that serves	 (bot: I am sorry but there is no english restaurant that matches your request)
user: food	 (bot: api_call R_cuisine east R_price)
user: thank you	 (bot: efes_restaurant is a great restaurant serving turkish food and it is in the moderate price range)
user: what ever	 (bot: What kind of food would you like?)
user: um surprise me	 (bot: api_call R_cuisine south expensive)
user: im looking for a restaurant that serves	 (bot: Would you like something in the cheap , moderate , or expensive price range?)
user: what type of food does the_missing_sock serve	 (bot: the_missing_sock serves international food)
user: barbecue food	 (bot: api_call thai west R_price)
user: im looking for a eritrean restaurant	 (bot: What kind of food would you like?)
user: eirtrean	 (bot: api_call eritrean R_location R_price)
user: area train	 (bot: What kind of food would you like?)
user: arotrian	 (bot: api_call R_cuisine R_location expensive)
user: area of the venue	 (bot: kymmoy is a nice place in the centre of town)
user: i want a malaysian restaurant	 (bot: I am sorry but there is no malaysian restaurant that matches your request)
user: opean	 (bot: api_call R_cuisine south R_price)
user: food	 (bot: I am sorry but there is no irish restaurant that matches your request)
user: whats the cost	 (bot: meghna is a nice restaurant in the north of town serving indian food)
user: what price range	 (bot: sesame_restaurant_and_bar is in the expensive price range)
user: okay um	 (bot: grafton_hotel_restaurant is a nice restaurant in the east of town in the expensive price range)
user: uh yes	 (bot: What part of town do you have in mind?)
user: i need	 (bot: api_call R_cuisine R_location R_price)
user: that serves takes out food	 (bot: api_call R_cuisine R_location cheap)
user: okay and what area is that	 (bot: little_seoul is a nice place in the centre of town)
user: hi im looking for cuban food	 (bot: I am sorry but there is no cuban restaurant that matches your request)
user: part of town	 (bot: Would you like something in the cheap , moderate , or expensive price range?)
user: how about	 (bot: gourmet_burger_kitchen is a nice restaurant in the centre of town serving north_american food)
user: how about in any area	 (bot: michaelhouse_cafe is a nice restaurant in the centre of town serving european food)
user: okay	 (bot: You are looking for a restaurant is that right?)
user: can you repeat that	 (bot: riverside_brasserie serves modern_european food .)
user: can you repeat that	 (bot: riverside_brasserie serves modern_european food .)
user: can you repeat that	 (bot: golden_wok is a nice restaurant in the north of town serving chinese food)
user: im looking for food	 (bot: Sorry there is no australasian restaurant in the west of town)
user: indonesian food	 (bot: api_call indonesian east R_price)
user: what kind of food is it	 (bot: sitar_tandoori serves indian food)
user: wait	 (bot: efes_restaurant is a great restaurant serving turkish food and it is in the moderate price range)
user: thank you	 (bot: efes_restaurant is a great restaurant serving turkish food and it is in the moderate price range)
user: i dont know	 (bot: Would you like something in the cheap , moderate , or expensive price range?)
user: okay	 (bot: saint_johns_chop_house is a nice restaurant in the west of town in the moderate price range)
user: hi im looking for a rerestaurant that serves cuban food	 (bot: I am sorry but there is no cuban restaurant that matches your request)
user: i dont know	 (bot: Would you like something in the cheap , moderate , or expensive price range?)
user: im looking for barbecue food	 (bot: I am sorry but there is no barbeque restaurant that matches your request)
user: does not matter	 (bot: There are restaurants in the expensive price range and the south of town . What type of food would you like?)
user: any type of food is okay	 (bot: api_call R_cuisine south expensive)
user: okay thank	 (bot: taj_tandoori is a nice restaurant in the south of town in the expensive price range)
user: catalan	 (bot: What kind of food would you like?)
user: catalan	 (bot: What part of town do you have in mind?)
user: what about asian food	 (bot: da_vinci_pizzeria is a nice restaurant in the north of town serving italian food)
user: im looking for asian food	 (bot: da_vinci_pizzeria is a great restaurant serving italian food and it is in the cheap price range)
user: im looking for a modreately	 (bot: What kind of food would you like?)
user: im looking	 (bot: What part of town do you have in mind?)
user: for restaurant	 (bot: api_call R_cuisine R_location R_price)
user: that serves	 (bot: What kind of food would you like?)
user: australasian	 (bot: api_call australasian R_location moderate)
user: how about modern europone	 (bot: riverside_brasserie is a great restaurant serving modern_european food and it is in the moderate price range)
user: and whats the phone number there	 (bot: The phone number of restaurant_alimentum is restaurant_alimentum_phone)
user: okay thank you	 (bot: restaurant_alimentum is a nice restaurant in the south of town in the moderate price range)
user: what is the addre	 (bot: Sure , pizza_hut_cherry_hinton is on pizza_hut_cherry_hinton_address)
user: jamaican	 (bot: api_call R_cuisine R_location expensive)
user: jamaican	 (bot: The price range at fitzbillies_restaurant is expensive .)
user: is there a jamaican restaurant	 (bot: Sorry there is no jamaican restaurant in the expensive price range)
user: what about us	 (bot: Sure , little_seoul is on little_seoul_address)
user: any type	 (bot: What part of town do you have in mind?)
user: airatarin	 (bot: What kind of food would you like?)
user: airatarin	 (bot: api_call R_cuisine north R_price)
user: what type of food is	 (bot: rajmahal serves indian food)
user: right	 (bot: api_call R_cuisine south moderate)
user: venetian	 (bot: I'm sorry but there is no restaurant serving middle_eastern food)
user: venetian	 (bot: I'm sorry but there is no restaurant serving indonesian food)
user: okay then any	 (bot: api_call R_cuisine R_location cheap)
user: location	 (bot: nandos is a nice place in the south of town)
user: okay then any part of town	 (bot: api_call indian R_location cheap)
user: scandinavian food	 (bot: I'm sorry but there is no restaurant serving scandinavian food)
user: what area is it	 (bot: midsummer_house_restaurant is a nice place in the centre of town)
user: any kind of food	 (bot: api_call R_cuisine north cheap)
user: id like a pan asian restaurant	 (bot: What part of town do you have in mind?)
user: pan asian	 (bot: What kind of food would you like?)
user: pan asian food	 (bot: I'm sorry but there is no restaurant serving venetian food)
user: pan asian	 (bot: I'm sorry but there is no restaurant serving polynesian food)
user: pan asian	 (bot: You are looking for a polynesian restaurant right?)
user: right	 (bot: api_call asian_oriental R_location R_price)
user: vegitarian	 (bot: I'm sorry but there is no restaurant serving vegetarian food)
user: scottish	 (bot: What kind of food would you like?)
user: malaysian food	 (bot: I'm sorry but there is no restaurant serving malaysian food)
user: danish food	 (bot: What part of town do you have in mind?)
user: yes knocking	 (bot: You are looking for a asian_oriental restaurant right?)
user: brazilian food	 (bot: What part of town do you have in mind?)
user: brazilian	 (bot: I'm sorry but there is no restaurant serving brazilian food)
user: whats the	 (bot: Did you say you are looking for a restaurant in the north of town?)
user: system	 (bot: restaurant_two_two is a nice place in the north of town)
user: system	 (bot: restaurant_two_two is a great restaurant)
user: system	 (bot: saigon_city is a great restaurant)
user: system	 (bot: meghna is a great restaurant)
user: system	 (bot: The post code of meghna is meghna_post_code)
user: system	 (bot: meghna is a nice place in the north of town)
user: system	 (bot: The post code of meghna is meghna_post_code)
user: system	 (bot: meghna is a great restaurant)
user: system	 (bot: The post code of meghna is meghna_post_code)
user: system	 (bot: Sure , da_vinci_pizzeria is on da_vinci_pizzeria_address)
user: system	 (bot: da_vinci_pizzeria is a great restaurant)
user: what type food	 (bot: efes_restaurant is in the moderate price range)
user: inaudible	 (bot: saigon_city serves asian_oriental food)
user: nosie	 (bot: api_call greek R_location R_price)
user: laugh	 (bot: I'm sorry but there is no restaurant serving polynesian food)
user: restaurant	 (bot: I'm sorry but there is no restaurant serving the_americas food)
user: oh jesus christ start over	 (bot: restaurant_one_seven is in the moderate price range)
user: laughing	 (bot: restaurant_one_seven is a great restaurant)
user: and where is that located	 (bot: la_tasca is a great restaurant)
user: laughing	 (bot: I'm sorry but there is no restaurant serving the_americas food)
user: any type	 (bot: api_call R_cuisine east expensive)
user: corsica	 (bot: I'm sorry but there is no restaurant serving corsica food)
user: any type	 (bot: You are looking for a restaurant serving any kind of food right?)
user: okay	 (bot: I'm sorry but there is no restaurant serving english food)
user: back	 (bot: Did you say you are looking for a restaurant in the west of town?)
user: back	 (bot: I'm sorry but there is no restaurant serving english food)
user: i need a restaurant serving corsica food	 (bot: I'm sorry but there is no restaurant serving corsica food)
user: thank you	 (bot: thanh_binh is a nice place in the west of town serving tasty vietnamese food)
user: any kind of food	 (bot: api_call R_cuisine east expensive)
user: polynesia food	 (bot: I'm sorry but there is no restaurant serving polynesian food)
user: more	 (bot: Let me confirm , You are looking for a restaurant in the moderate price range right?)
user: yeah	 (bot: What part of town do you have in mind?)
user: expe	 (bot: Ok , a restaurant in any part of town is that right?)
user: what type of food is served	 (bot: saint_johns_chop_house serves british food)
user: any type	 (bot: api_call R_cuisine south cheap)
user: type of food they served	 (bot: nandos is a great restaurant)
user: food type	 (bot: the_lucky_star is a nice place in the south of town and the prices are cheap)
user: nandos restaurant type of food	 (bot: nandos is a nice place in the south of town and the prices are cheap)
user: what type of food is served	 (bot: nandos serves portuguese food)
user: and price range	 (bot: little_seoul is in the expensive price range , and their post code is C.B 2, 1 D.P)
user: i do not care	 (bot: api_call mediterranean R_location R_price)
user: i do not care	 (bot: api_call R_cuisine south expensive)
user: yeah	 (bot: I'm sorry but there is no restaurant serving bistro food)
user: how about uh	 (bot: api_call turkish R_location R_price)
user: uh id like steakhouse food	 (bot: What part of town do you have in mind?)
user: steakhouse	 (bot: I'm sorry but there is no restaurant serving steakhouse food)
user: uh medium	 (bot: api_call turkish R_location R_price)
user: food	 (bot: I'm sorry but there is no restaurant serving belgian food)
user: range that serves cana	 (bot: ali_baba is in the moderate price range)
user: right	 (bot: curry_prince serves indian food in the moderate price range)
user: may i have the phone number talking	 (bot: The phone number of the_nirala is the_nirala_phone)
user: right	 (bot: Let me confirm , You are looking for a restaurant in the expensive price range right?)
user: right	 (bot: api_call korean R_location expensive)
user: inaudible	 (bot: What part of town do you have in mind?)
user: moder	 (bot: You are looking for a restaurant serving any kind of food right?)
user: any type of food	 (bot: api_call R_cuisine east expensive)
user: and what type of food is that	 (bot: pipasha_restaurant serves indian food)
user: anywhere	 (bot: Let me confirm , You are looking for a restaurant in the moderate price range right?)
user: what about other parts of town	 (bot: Did you say you are looking for a restaurant in the east of town?)
user: what about other parts of town	 (bot: I'm sorry but there is no chinese restaurant in the east of town and the moderate price range)
user: sea food	 (bot: Let me confirm , You are looking for a restaurant and you dont care about the price range right?)
user: do they serve	 (bot: golden_wok is a great restaurant)
user: in what area	 (bot: la_tasca is a nice place in the centre of town)
user: right	 (bot: api_call spanish R_location R_price)
user: right	 (bot: I'm sorry but there is no restaurant serving cheap thai food)
user: how about any price range	 (bot: api_call thai R_location R_price)
user: belgium food	 (bot: What part of town do you have in mind?)
user: malyasian	 (bot: What kind of food would you like?)
user: food	 (bot: What part of town do you have in mind?)
user: food	 (bot: Did you say you are looking for a restaurant in the east of town?)
user: um	 (bot: curry_prince is a nice place in the east of town)
user: i do not care	 (bot: api_call R_cuisine west cheap)
user: scandinavian	 (bot: I'm sorry but there is no restaurant serving scandinavian food)
user: and what area	 (bot: the cow pizza kitchen and bar is a nice place in the centre of town)
user: whats the type of food	 (bot: the_lucky_star is a great restaurant)
user: gastro pub	 (bot: What part of town do you have in mind?)
user: breathing	 (bot: api_call world R_location R_price)
user: catalan	 (bot: I'm sorry but there is no restaurant serving moderate korean food)
user: repeat	 (bot: Let me confirm , You are looking for a restaurant in the moderate price range right?)
user: um yes	 (bot: I'm sorry but there is no restaurant serving danish food)
user: catalan	 (bot: the cow pizza kitchen and bar is in the moderate price range)
user: what kind of food is that	 (bot: the cow pizza kitchen and bar serves gastropub food)
user: serves what	 (bot: api_call catalan R_location moderate)
user: addre	 (bot: Sure , galleria is on galleria_address)
user: jamaican	 (bot: api_call R_cuisine R_location cheap)
user: what kind of food	 (bot: nandos_city_centre is a great restaurant)
user: i need jamaican food	 (bot: api_call chinese R_location cheap)
user: jamaican	 (bot: the_lucky_star is a great restaurant)
user: thank you	 (bot:  you are welcome)
user: any kind of food	 (bot: the good luck chinese food takeaway is a nice place in the south of town and the prices are expensive)
user: any kind of food	 (bot: api_call R_cuisine west moderate)
user: thank you	 (bot: I'm sorry but there is no restaurant serving cantonese food)
user: thank you	 (bot: restaurant_alimentum is a great restaurant)
user: airitran	 (bot: What kind of food would you like?)
user: aw give me the damn code	 (bot: Ok , a restaurant in any part of town is that right?)
user: what kind of food	 (bot: thanh_binh serves vietnamese food)
user: what kind of food	 (bot: royal_spice serves indian food)
user: usually	 (bot: j_restaurant is in the cheap price range)
user: different kind of food	 (bot: kohinoor is a great restaurant)
user: i changed my mind	 (bot: dojo_noodle_bar is in the cheap price range)
user: may i have the phone number to the turkiesh	 (bot: I'm sorry but there is no restaurant serving world food)
user: restaurant	 (bot: You are looking for a world restaurant right?)
user: turkey food	 (bot: I'm sorry but there is no restaurant serving world food)
user: thank you	 (bot: Sorry I am a bit confused ; please tell me again what you are looking for .)
user: food	 (bot: I'm sorry but there is no restaurant serving greek food)
user: sea food	 (bot: api_call R_cuisine R_location expensive)
user: repeat	 (bot: da_vinci_pizzeria is in the cheap price range)
user: sea food	 (bot: la_raza is in the cheap price range)
user: inaudible	 (bot: saint_johns_chop_house is a nice place in the west of town and the prices are moderate)
user: food	 (bot: eraina is in the expensive price range)
user: is there another alternative	 (bot: eraina is a great restaurant)
user: jamaican food	 (bot: What kind of food would you like?)
user: jamaican	 (bot: Sorry would you like jamaican food or you dont care)
user: what kind of food is there	 (bot: grafton_hotel_restaurant is a great restaurant)
user: what kind of food	 (bot: grafton_hotel_restaurant serves british food)
user: no new selection	 (bot: Did you say you are looking for a restaurant in the west of town?)
user: im looking chineese food	 (bot: Would you like something in the cheap , moderate , or expensive price range?)
user: next	 (bot: api_call chinese south R_price)
user: next	 (bot: peking_restaurant is a nice place in the south of town serving tasty chinese food)
user: next	 (bot: I am sorry but there is no other chinese restaurant in the south of town)
user: whats the area	 (bot: the cow pizza kitchen and bar is a nice place in the centre of town)
user: i want malaysian food in any area	 (bot: Ok , a restaurant in any part of town is that right?)
user: restaurant and it should serve steak house food	 (bot: I'm sorry but there is no restaurant serving steakhouse food)
user: okay whats the address for that	 (bot: Sure , meghna is on meghna_address)
user: yes barbecue food	 (bot: Let me confirm , You are looking for a restaurant in the cheap price range right?)
user: um	 (bot: I'm sorry but there is no restaurant serving cheap european food)
user: is there	 (bot: You are looking for a european restaurant right?)
user: right	 (bot: Let me confirm , You are looking for a restaurant in the cheap price range right?)
user: okay just regular ecuadorean food	 (bot: I'm sorry but there is no restaurant serving cheap european food)
user: russian food	 (bot: I'm sorry but there is no restaurant serving russian food)
user: crossover food	 (bot: What kind of food would you like?)
user: stop it	 (bot: You are looking for a restaurant serving any kind of food right?)
user: right	 (bot: What kind of food would you like?)
user: wrong	 (bot: Let me confirm , You are looking for a restaurant in the expensive price range right?)
user: right	 (bot: Let me confirm , You are looking for a restaurant in the expensive price range right?)
user: right	 (bot: What part of town do you have in mind?)
user: polish	 (bot: I'm sorry but there is no restaurant serving polish food)
user: correct	 (bot: api_call R_cuisine north moderate)
user: may i know more about the area	 (bot: little_seoul is a nice place in the centre of town)
user: can i have the address of that	 (bot: Sure , restaurant_alimentum is on restaurant_alimentum_address)
user: whats its number	 (bot: sala_thong is a great restaurant)
user: danish food	 (bot: I'm sorry but there is no restaurant serving english food)
user: no danish food	 (bot: Sorry would you like danish or english food?)
user: restaurant	 (bot: What part of town do you have in mind?)
user: singaporean	 (bot: I'm sorry but there is no restaurant serving singaporean food)
user: yea	 (bot: api_call world R_location R_price)
user: portugese	 (bot: api_call R_cuisine south R_price)
user: price	 (bot: What part of town do you have in mind?)
user: addre	 (bot: royal_spice is a great restaurant)
user: malaysian food	 (bot: I'm sorry but there is no restaurant serving polynesian food)
user: malaysian food	 (bot: You are looking for a malaysian restaurant right?)
user: i do not care	 (bot: You are looking for a restaurant serving any kind of food right?)
user: correct	 (bot: api_call R_cuisine south moderate)
user: class over	 (bot: What kind of food would you like?)
user: cross over	 (bot: api_call R_cuisine west R_price)
user: right	 (bot: api_call R_cuisine west moderate)
user: yes right	 (bot: I'm sorry but there is no north_american restaurant in the south of town)
user: right	 (bot: I'm sorry but there is no north_american restaurant in the west of town)
user: barbecue	 (bot: What part of town do you have in mind?)
user: right	 (bot: api_call R_cuisine east R_price)
user: fuck the_missing_sock	 (bot: the_missing_sock is a great restaurant)
user: barbecue food	 (bot: I'm sorry but there is no portuguese restaurant in the east of town)
user: barbecue food	 (bot: Did you say you are looking for a restaurant in the east of town?)
user: thank you	 (bot: You are looking for a indian restaurant right?)
user: any thing	 (bot: api_call R_cuisine west cheap)
user: repeat that	 (bot: Would you like something in the cheap , moderate , or expensive price range?)
user: any range is fine	 (bot: Let me confirm , You are looking for a restaurant and you dont care about the price range right?)
user: im looking for a restaurant in any area that serves russian food	 (bot: Ok , a restaurant in any part of town is that right?)
user: russian	 (bot: I'm sorry but there is no restaurant serving russian food)
user: could you repeat the name	 (bot: loch_fyne is a great restaurant)
user: system	 (bot: What part of town do you have in mind?)
user: restaurant	 (bot: What part of town do you have in mind?)
user: blow	 (bot: What kind of food would you like?)
user: wrong	 (bot: api_call R_cuisine north cheap)
user: food	 (bot: the_missing_sock serves international food)
user: adress	 (bot: da_vinci_pizzeria is a nice place in the north of town serving tasty italian food)
user: adress	 (bot: I am sorry but there is no other italian restaurant in the north of town)
user: inaudible	 (bot: What kind of food would you like?)
user: what kind of food	 (bot: meghna is a great restaurant)
user: what food do they serve	 (bot: meghna serves indian food)
user: can i try another one	 (bot: I'm sorry but there is no restaurant serving polynesian food)
user: right	 (bot: the river bar steakhouse and grill serves modern_european food)
user: is there another one	 (bot: api_call polynesian R_location R_price)
user: any food	 (bot: You are looking for a restaurant serving any kind of food right?)
user: can i have another option	 (bot: the_nirala is a nice place in the north of town and the prices are moderate)
user: that serves corsica	 (bot: What kind of food would you like?)
user: what is the	 (bot: little_seoul is a great restaurant)
user: hello	 (bot: What part of town do you have in mind?)
user: the addre	 (bot: pizza_hut_fen_ditton is a nice place in the east of town)
user: what is the addre	 (bot: Sure , pizza_hut_fen_ditton is on pizza_hut_fen_ditton_address)
user: talian food	 (bot: I'm sorry but there is no restaurant serving australian food)
user: chikkis	 (bot: api_call R_cuisine R_location R_price)
user: part of town	 (bot: What kind of food would you like?)
user: town	 (bot: the_lucky_star is in the cheap price range)
user: part of town	 (bot: the river bar steakhouse and grill is in the cheap price range)
user: uh any type of food	 (bot: api_call R_cuisine south moderate)
user: serve	 (bot: pizza_hut_cherry_hinton is a nice place in the south of town and the prices are moderate)
user: right	 (bot: api_call mediterranean R_location R_price)
user: uh	 (bot: I am sorry but there is no other korean restaurant that matches your request)
user: what about food restaurants	 (bot: api_call korean R_location R_price)
user: sea food	 (bot: api_call R_cuisine north R_price)
user: portugese	 (bot: api_call tuscan south R_price)
user: barbecue food	 (bot: What part of town do you have in mind?)
user: whats the type of food	 (bot: pizza_hut_cherry_hinton is a great restaurant)
user: the food of the venue	 (bot: Sorry but there is no other restaurant in the moderate price range and the south of town)
user: food of the venue	 (bot: restaurant_alimentum is a nice place in the south of town and the prices are moderate)
user: type	 (bot: pizza_hut_cherry_hinton is a great restaurant)
user: food type	 (bot: Sorry but there is no other restaurant in the moderate price range and the south of town)
user: thank you	 (bot: pizza_hut_cherry_hinton is a great restaurant)
user: yea	 (bot: You are looking for a romanian restaurant right?)
user: yea	 (bot: api_call mediterranean R_location expensive)
user: catalan	 (bot: What kind of food would you like?)
user: catalanian	 (bot: api_call catalan east R_price)
user: any price	 (bot: nandos is a great restaurant)
user: yea	 (bot: api_call thai west R_price)
user: um what	 (bot: little_seoul is a great restaurant)
user: and	 (bot: dojo_noodle_bar is a great restaurant)
user: dont	 (bot: What kind of food would you like?)
user: arts town	 (bot: What part of town do you have in mind?)
user: anywhere	 (bot: What kind of food would you like?)
user: cough	 (bot: api_call R_cuisine west R_price)
user: it deosnt matter	 (bot: api_call italian south R_price)
user: right	 (bot: api_call thai west R_price)
user: ring	 (bot: What part of town do you have in mind?)
user: pan asian food	 (bot: What kind of food would you like?)
user: cough	 (bot: I'm sorry but there is no spanish restaurant in the west of town)
user: pan asian food	 (bot: Did you say you are looking for a restaurant in the west of town?)
user: addrss	 (bot: rice_boat is a great restaurant)
user: any type	 (bot: You are looking for a restaurant serving any kind of food right?)
user: right	 (bot: Would you like something in the cheap , moderate , or expensive price range?)
user: any range	 (bot: Let me confirm , You are looking for a restaurant and you dont care about the price range right?)
user: uh scandinavian food	 (bot: I'm sorry but there is no restaurant serving indonesian food)
user: okay is there	 (bot: api_call mediterranean R_location cheap)
user: i want to find a	 (bot: the_gardenia is a great restaurant)
user: hello	 (bot: What part of town do you have in mind?)
user: what is available	 (bot: api_call R_cuisine south R_price)
user: thank you	 (bot: chiquito_restaurant_bar is a great restaurant)
user: i know mia	 (bot: the_cambridge_chop_house serves british food in the expensive price range)
user: ye	 (bot: api_call canapes R_location cheap)
user: im looking for a restaurant	 (bot: Sorry would you like the west of town or you dont care)
user: static	 (bot: I am sorry but there is no other european restaurant in the west of town)
user: static	 (bot: cambridge_lodge_restaurant is a nice place in the west of town serving tasty european food)
user: i would like	 (bot: Sorry would you like unusual or european food?)
user: scandinavian	 (bot: I'm sorry but there is no restaurant serving scandinavian food)
user: any price range is fine	 (bot: api_call chinese south R_price)
user: thank you	 (bot: golden_wok is a great restaurant)
user: thank you	 (bot: golden_wok is a great restaurant serving moderate chinese food in the north of town .)
user: thank you	 (bot: golden_wok is a great restaurant)
user: polish food	 (bot: I'm sorry but there is no restaurant serving polish food)
user: food type	 (bot: I'm sorry but there is no north_american restaurant in the north of town)
user: any food	 (bot: Would you like something in the cheap , moderate , or expensive price range?)
user: thank you	 (bot: curry_prince is a great restaurant)
user: cough	 (bot: la_margherita is a nice place in the west of town and the prices are cheap)
user: 7:30	 (bot: What part of town do you have in mind?)
user: scandinavian food	 (bot: I'm sorry but there is no restaurant serving scandinavian food)
user: barbecue	 (bot: What kind of food would you like?)
user: barbecue	 (bot: Would you like something in the cheap , moderate , or expensive price range?)
user: singaporean food	 (bot: api_call singaporean R_location R_price)
user: corsica food	 (bot: What kind of food would you like?)
user: hello	 (bot: api_call R_cuisine R_location R_price)
user: more	 (bot: What part of town do you have in mind?)
user: more	 (bot: What kind of food would you like?)
user: asian	 (bot: I'm sorry but there is no restaurant serving swiss food)
user: asian	 (bot: I'm sorry but there is no restaurant serving swiss food)
user: and the	 (bot: Did you say you are looking for a restaurant in the south of town?)
user: yea	 (bot: the good luck chinese food takeaway is a nice place in the south of town serving tasty chinese food)
user: uh restaurant	 (bot: I am sorry but there is no other mexican restaurant that matches your request)
user: any type	 (bot: api_call R_cuisine north cheap)
user: i need cant	 (bot: What part of town do you have in mind?)
user: unitelligible food	 (bot: You are looking for a panasian restaurant right?)
user: thank you	 (bot: galleria is a great restaurant)
user: asian ori	 (bot: I'm sorry but there is no restaurant serving german food)
user: asian	 (bot: Let me confirm , You are looking for a restaurant in the cheap price range right?)
user: pub	 (bot: Did you say you are looking for a restaurant in the south of town?)
user: whats their price range	 (bot: peking_restaurant is in the expensive price range)
user: thank you	 (bot: peking_restaurant is a great restaurant)
user: and the phone number again	 (bot: The phone number of chiquito_restaurant_bar is chiquito_restaurant_bar_phone)
user: what was the phone number for chiquito	 (bot: The phone number of frankie_and_bennys is frankie_and_bennys_phone)
user: chiquito	 (bot: peking_restaurant is a nice place in the south of town and the prices are expensive)
user: and phone nubmer	 (bot: The phone number of yippee_noodle_bar is yippee_noodle_bar_phone)
user: the restaurant	 (bot: What part of town do you have in mind?)
user: and what area is it	 (bot: kymmoy is a nice place in the centre of town)
user: hello and welcome to the cambridge	 (bot: What part of town do you have in mind?)
user: hello and welcome	 (bot: What part of town do you have in mind?)
user: catalan	 (bot: What kind of food would you like?)
user: could i get the phone number and	 (bot: The phone number of cotto is cotto_phone)
user: what about	 (bot: Did you say you are looking for a restaurant in the north of town?)
user: address phone number price range	 (bot: The phone number of prezzo is prezzo_phone)
user: venetian food	 (bot: What part of town do you have in mind?)
user: venetian	 (bot: What kind of food would you like?)
user: jamaican	 (bot: I'm sorry but there is no restaurant serving jamaican food)
user: whats the area	 (bot: cambridge_lodge_restaurant is a great restaurant)
user: uh any type	 (bot: api_call R_cuisine west moderate)
user: hello	 (bot: What part of town do you have in mind?)
user: what was their address again please	 (bot: Sure , meghna is on meghna_address)
user: um is doesnt matter	 (bot: What kind of food would you like?)
user: ye	 (bot: api_call european west R_price)
user: and what type of food	 (bot: nandos serves portuguese food)
user: right	 (bot: I'm sorry but there is no spanish restaurant in the north of town)
user: is there any thing else	 (bot: meghna is a nice place in the north of town)
user: and the type of food	 (bot: meghna is a great restaurant)
user: could you repeat that	 (bot: grafton_hotel_restaurant is a great restaurant)
user: hello	 (bot: I'm sorry but there is no restaurant serving halal food)
user: hello	 (bot: I'm sorry but there is no restaurant serving indonesian food)
user: cough	 (bot: What part of town do you have in mind?)
user: whats the phone number for that restaurant	 (bot: The phone number of wagamama is wagamama_phone)
user: any type	 (bot: api_call R_cuisine east expensive)
user: okay	 (bot: la_margherita is a nice place in the west of town and the prices are cheap)
user: restaurants	 (bot: What part of town do you have in mind?)
user: what is price range	 (bot: thanh_binh is in the cheap price range)
user: food	 (bot: I'm sorry but there is no restaurant serving cheap korean food)
user: food	 (bot: Let me confirm , You are looking for a restaurant in the cheap price range right?)
user: food	 (bot: I'm sorry but there is no restaurant serving cheap korean food)
user: food	 (bot: Let me confirm , You are looking for a restaurant in the cheap price range right?)
user: post	 (bot: peking_restaurant is a nice place in the south of town)
user: old	 (bot: the_lucky_star is a nice place in the south of town)
user: cough	 (bot: api_call R_cuisine south cheap)
user: im looking for a restaurant in any area	 (bot: What kind of food would you like?)
user: what kind of food is it	 (bot: grafton_hotel_restaurant serves british food)
user: jamaican food	 (bot: api_call jamaican west R_price)
user: jamaican food	 (bot: india_house is a great restaurant)
user: jamaican food	 (bot: cocum is a nice place in the west of town)
user: what kind of food is it	 (bot: cocum serves indian food)
user: what kind of food is that	 (bot: thanh_binh serves vietnamese food)
user: try calling again in one minuet	 (bot: graffiti is a nice place in the west of town)
user: vietnam	 (bot: I'm sorry but there is no restaurant serving venetian food)
user: food	 (bot: You are looking for a venetian restaurant right?)
user: vietnam	 (bot: I'm sorry but there is no restaurant serving venetian food)
user: uh continental	 (bot: What kind of food would you like?)
user: right	 (bot: api_call chinese R_location cheap)
user: cough	 (bot: What part of town do you have in mind?)
user: malyasian	 (bot: I'm sorry but there is no restaurant serving malaysian food)
user: i dont know	 (bot: api_call R_cuisine north moderate)
user: thank you	 (bot: pizza_hut_fen_ditton is a great restaurant)
user: um i dont know	 (bot: api_call R_cuisine east R_price)
user: did you hang up on me	 (bot: api_call R_cuisine east moderate)
user: okay uh	 (bot: api_call brazilian R_location moderate)
user: okay and what area	 (bot: the cow pizza kitchen and bar is a nice place in the centre of town)
user: okay um	 (bot: I am sorry but there is no other mediterranean restaurant in the cheap price range)
user: okay what kind of food	 (bot: royal_spice serves indian food)
user: uh doesnt matter	 (bot: What part of town do you have in mind?)
user: okay	 (bot: I'm sorry but there is no restaurant serving danish food)
user: uh yes im looking for malaysian food	 (bot: I'm sorry but there is no restaurant serving malaysian food)
user: okay and um	 (bot: restaurant_two_two serves french food)
user: go back	 (bot: Sorry but there is no other restaurant in the moderate price range and the west of town)
user: okay	 (bot: saint_johns_chop_house is a nice place in the west of town and the prices are moderate)
user: okay	 (bot: I'm sorry but there is no restaurant serving cuban food)
user: that serves	 (bot: You are looking for a cuban restaurant right?)
user: that serves	 (bot: What part of town do you have in mind?)
user: moroccon	 (bot: I'm sorry but there is no restaurant serving moroccan food)
user: serving jamaican food	 (bot: I'm sorry but there is no restaurant serving jamaican food)
user: breathing	 (bot: What part of town do you have in mind?)
user: breathing	 (bot: What part of town do you have in mind?)
user: pan asian food	 (bot: api_call R_cuisine R_location cheap)
user: what kind of food is it	 (bot: golden_house serves chinese food)
user: how much	 (bot: What part of town do you have in mind?)
user: im looking for um	 (bot: Sorry would you like the south of town or you dont care)
user: im looking for um	 (bot: Did you say you are looking for a restaurant in the south of town?)
user: restaurant in central	 (bot: Ok , a restaurant in any part of town is that right?)
user: danish food	 (bot: I'm sorry but there is no restaurant serving danish food)
user: food	 (bot: What part of town do you have in mind?)
user: okay	 (bot: I'm sorry but there is no restaurant serving barbeque food)
user: how about asian food	 (bot: I'm sorry but there is no restaurant serving barbeque food)
user: sure how about asian food	 (bot: Did you say you are looking for a restaurant in the north of town?)
user: ye	 (bot: You are looking for a barbeque restaurant right?)
user: how about asian food	 (bot: I'm sorry but there is no restaurant serving barbeque food)
user: yes yes	 (bot: What kind of food would you like?)
user: okay thank you	 (bot: the_lucky_star is a great restaurant)
user: cough	 (bot: What part of town do you have in mind?)
user: um i dont know	 (bot: api_call R_cuisine south R_price)
user: i dont know	 (bot: api_call R_cuisine south moderate)
user: restaurant	 (bot: I'm sorry but there is no french restaurant in the west of town)
user: okay	 (bot: saint_johns_chop_house is a great restaurant)
user: well take that one	 (bot: saint_johns_chop_house is a great restaurant)
user: can i have the area of the venue	 (bot: la_raza is a nice place in the centre of town)
user: price	 (bot: I am sorry but there is no other japanese restaurant that matches your request)
user: right	 (bot: What part of town do you have in mind?)
user: what	 (bot: grafton_hotel_restaurant is a nice place in the east of town and the prices are expensive)
user: im looking for	 (bot: What part of town do you have in mind?)
user: yea	 (bot: What kind of food would you like?)
user: static	 (bot: What kind of food would you like?)
user: okay what type of food is that	 (bot: da_vinci_pizzeria serves italian food)
user: i dont	 (bot: la_margherita is a great restaurant serving cheap italian food in the west of town .)
user: care	 (bot: Sorry but there is no other italian restaurant in the cheap price range and the west of town)
user: hello	 (bot: What part of town do you have in mind?)
user: im looking for a food	 (bot: What part of town do you have in mind?)
user: thank you	 (bot: the_slug_and_lettuce is a great restaurant)
user: canope food	 (bot: I'm sorry but there is no restaurant serving canapes food)
user: right	 (bot: the river bar steakhouse and grill serves modern_european food)
user: right	 (bot: the cow pizza kitchen and bar serves gastropub food in the moderate price range)
user: viet	 (bot: maharajah_tandoori_restaurant is a great restaurant)
user: address and	 (bot: Sure , maharajah_tandoori_restaurant is on maharajah_tandoori_restaurant_address)
user: address phone number area	 (bot: The phone number of little_seoul is little_seoul_phone)
user: right	 (bot: api_call indian east R_price)
user: thank you	 (bot:  you are welcome)
user: steakhouse	 (bot: Ok , a restaurant in any part of town is that right?)
user: i would like steakhouse food	 (bot: I'm sorry but there is no restaurant serving steakhouse food)
user: hello hello oh your on the phone yea	 (bot: I am sorry but there is no other turkish restaurant that matches your request)
user: what is what area is it in	 (bot: the cow pizza kitchen and bar is a nice place in the centre of town)
user: can i get	 (bot: What part of town do you have in mind?)
user: belgium food	 (bot: You are looking for a german restaurant right?)
user: no belgium	 (bot: I'm sorry but there is no restaurant serving belgian food)
user: malaysian	 (bot: I'm sorry but there is no restaurant serving malaysian food)
user: what is the	 (bot: prezzo is a great restaurant)
user: yea	 (bot: Let me confirm , You are looking for a restaurant in the moderate price range right?)
user: persian food	 (bot: I'm sorry but there is no restaurant serving persian food)
user: yea	 (bot: What kind of food would you like?)
user: any time	 (bot: api_call R_cuisine south expensive)
user: signaporian	 (bot: api_call R_cuisine R_location R_price)
user: system	 (bot: What part of town do you have in mind?)
user: what about any area	 (bot: api_call turkish east R_price)
user: 	 (bot: Ok , a restaurant in any part of town is that right?)
user: that food	 (bot: sala_thong serves thai food in the expensive price range)
user: 	 (bot: sala_thong is a great restaurant)
user: 	 (bot: sala_thong is a great restaurant)
user: 	 (bot: The post code of sala_thong is sala_thong_post_code)
user: 	 (bot: sala_thong is a great restaurant)
user: 	 (bot: don_pasquale_pizzeria is in the expensive price range)
user: scandinavian food	 (bot: Would you like something in the cheap , moderate , or expensive price range?)
user: scandinavian food	 (bot: I'm sorry but there is no restaurant serving scandinavian food)
user: im looking for venison food cross talk	 (bot: I'm sorry but there is no restaurant serving venetian food)
user: cross talk how about gastro pub	 (bot: You are looking for a venetian restaurant right?)
user: how about gastro pub	 (bot: You are looking for a venetian restaurant right?)
user: how about gastro pub type of food	 (bot: api_call R_cuisine R_location R_price)
user: what type of food is this	 (bot: royal_standard serves gastropub food)
user: who is it by	 (bot:  you are welcome)
user: any type	 (bot: api_call R_cuisine west moderate)
user: i need	 (bot: Would you like something in the cheap , moderate , or expensive price range?)
user: brazilian	 (bot: I'm sorry but there is no restaurant serving brazilian food)
user: gastro pub	 (bot: I'm sorry but there is no restaurant serving cheap gastropub food)
user: its a type of food	 (bot: nandos serves portuguese food)
user: okay	 (bot: I'm sorry but there is no mediterranean restaurant in the south of town)
user: okay	 (bot: api_call R_cuisine R_location expensive)
user: any type of food	 (bot: api_call R_cuisine west cheap)
user: is there a	 (bot: I'm sorry but there is no restaurant serving brazilian food)
user: start over	 (bot: I'm sorry but there is no restaurant serving fusion food)
user: restaurant	 (bot: I'm sorry but there is no restaurant serving fusion food)
user: find restaurant	 (bot: Did you say you are looking for a restaurant in the north of town?)
user: any more	 (bot: eraina serves european food)
user: yea	 (bot: api_call portuguese R_location R_price)
user: any type of food	 (bot: Would you like something in the cheap , moderate , or expensive price range?)
user: thank you	 (bot: meze_bar_restaurant is a great restaurant)
user: i do not care	 (bot: api_call R_cuisine north moderate)
user: and the type of food	 (bot: golden_wok serves chinese food)
user: id like a restaurant in any area	 (bot: What kind of food would you like?)
user: ad	 (bot: the_missing_sock is a great restaurant)
user: food	 (bot: yu_garden is a nice place in the east of town and the prices are expensive)
user: food	 (bot: royal_standard is a nice place in the east of town and the prices are expensive)
user: right	 (bot: api_call thai R_location R_price)
user: thank you	 (bot: I'm sorry but there is no restaurant serving indonesian food)
user: worthless system	 (bot: Did you say you are looking for a restaurant in the north of town?)
user: id like a	 (bot: api_call R_cuisine east moderate)
user: any food	 (bot: api_call R_cuisine south moderate)
user: any kind of food	 (bot: api_call R_cuisine south cheap)
user: any kind of food	 (bot: api_call R_cuisine south moderate)
user: i want indonesian food	 (bot: I'm sorry but there is no restaurant serving indonesian food)
user: right	 (bot: api_call north_american R_location R_price)
user: malaysian	 (bot: api_call R_cuisine R_location moderate)
user: thank you	 (bot: restaurant_alimentum is a great restaurant)
user: so	 (bot: What part of town do you have in mind?)
user: so	 (bot: Did you say you are looking for a restaurant in the south of town?)
user: the	 (bot: What part of town do you have in mind?)
user: the area	 (bot: meghna serves indian food in the moderate price range)
user: the area	 (bot: meghna is a great restaurant)
user: what area of town	 (bot: meghna is a nice place in the north of town)
user: basque	 (bot: api_call R_cuisine R_location expensive)
user: what kind of food	 (bot: meze_bar_restaurant serves turkish food)
user: basque	 (bot: the_cambridge_chop_house is in the expensive price range)
user: basque	 (bot: royal_standard is in the expensive price range)
user: what area of town	 (bot: little_seoul is a nice place in the centre of town)
user: i want a restaurant serving	 (bot: You are looking for a hungarian restaurant right?)
user: i want a basque food restaurant	 (bot: What part of town do you have in mind?)
user: basque food	 (bot: I'm sorry but there is no restaurant serving basque food)
user: how about	 (bot: You are looking for a basque restaurant right?)
user: any type of food	 (bot: api_call R_cuisine south moderate)
user: what price range	 (bot: api_call korean R_location R_price)
user: any kind of food	 (bot: api_call R_cuisine north R_price)
user: modern europene	 (bot: api_call R_cuisine south R_price)
user: corsica food	 (bot: What part of town do you have in mind?)
user: inaudible	 (bot: What kind of food would you like?)
user: price	 (bot: la_tasca is a great restaurant)
user: prices	 (bot: la_raza serves spanish food)
user: have a good	 (bot: la_raza is a great restaurant)
user: danish food	 (bot: I'm sorry but there is no restaurant serving english food)
user: cuban	 (bot: What kind of food would you like?)
user: cuban	 (bot: You are looking for a restaurant serving any kind of food right?)
user: okay	 (bot: Sure , thanh_binh is on thanh_binh_address)
user: thank you	 (bot: thanh_binh is a great restaurant)
user: next one	 (bot: the_lucky_star is a nice place in the south of town and the prices are cheap)
user: next one	 (bot: Sorry but there is no other restaurant in the cheap price range and the south of town)
user: previews	 (bot: nandos is a nice place in the south of town and the prices are cheap)
user: cuban	 (bot: I'm sorry but there is no restaurant serving cuban food)
user: scottish	 (bot: api_call R_cuisine west R_price)
user: another place	 (bot: the_hotpot is a great restaurant)
user: breathing	 (bot: city_stop_restaurant is a nice place in the north of town and the prices are expensive)
user: breathing	 (bot: city_stop_restaurant is a great restaurant)
user: right	 (bot: api_call italian R_location R_price)
user: venetian food	 (bot: I'm sorry but there is no restaurant serving english food)
user: venetian food	 (bot: I'm sorry but there is no restaurant serving venetian food)
user: i want a restaurant in the that serves belgium food	 (bot: I'm sorry but there is no restaurant serving belgian food)
user: for a restaurant	 (bot: What part of town do you have in mind?)
user: part of town that serves asian food	 (bot: Ok , a restaurant in any part of town is that right?)
user: and asian food	 (bot: You are looking for a restaurant serving any kind of food right?)
user: no im looking for pan asian food	 (bot: Would you like something in the cheap , moderate , or expensive price range?)
user: uh doesnt matter	 (bot: api_call R_cuisine east R_price)
user: im looking	 (bot: pipasha_restaurant is a nice place in the east of town)
user: ok talian food	 (bot: I'm sorry but there is no restaurant serving halal food)
user: catalen food	 (bot: I'm sorry but there is no restaurant serving halal food)
user: i am looking for catalin food	 (bot: You are looking for a halal restaurant right?)
user: bad	 (bot: I'm sorry but there is no restaurant serving halal food)
user: what area of town is it in	 (bot: caffe_uno is a nice place in the centre of town)
user: care	 (bot: Sorry would you like the west of town or you dont care)
user: im	 (bot: What part of town do you have in mind?)
user: okay good whats the address for that one	 (bot: I am sorry but there is no other spanish restaurant that matches your request)
user: looking for a basque restaurant	 (bot: I'm sorry but there is no restaurant serving basque food)
user: what area is that	 (bot: la_raza is a nice place in the centre of town)
user: uh huh	 (bot: the_golden_curry serves indian food)
user: any type of food	 (bot: api_call R_cuisine east expensive)
user: um what	 (bot: sitar_tandoori is a nice place in the east of town and the prices are expensive)
user: could i have its number	 (bot: india_house is a great restaurant)
user: may i have its number	 (bot: The phone number of india_house is india_house_phone)
user: where is it located	 (bot: Sure , bloomsbury_restaurant is on bloomsbury_restaurant_address)
user: restaurant	 (bot: What part of town do you have in mind?)
user: basque food	 (bot: I'm sorry but there is no restaurant serving basque food)
user: serving catalan food	 (bot: I'm sorry but there is no restaurant serving catalan food)
user: thank you	 (bot: What part of town do you have in mind?)
user: and asian	 (bot: api_call R_cuisine R_location cheap)
user: pan asian	 (bot: dojo_noodle_bar is in the cheap price range)
user: i do not care	 (bot: api_call chinese south R_price)
user: uh price range	 (bot: chiquito_restaurant_bar is in the expensive price range)
user: any of town	 (bot: Did you say you are looking for a restaurant in the centre of town?)
user: thank you	 (bot: thanh_binh is a great restaurant)
user: and what type of food is it	 (bot: da_vinci_pizzeria serves italian food)
user: barbecue	 (bot: I'm sorry but there is no restaurant serving barbeque food)
user: not	 (bot: What part of town do you have in mind?)
user: air tran	 (bot: Would you like something in the cheap , moderate , or expensive price range?)
user: any kind of food	 (bot: api_call R_cuisine north moderate)
user: can i have the type of food	 (bot: meghna serves indian food)
user: restaurant	 (bot: What part of town do you have in mind?)
user: hello	 (bot: saigon_city is a nice place in the north of town)
user: any where	 (bot: Ok , a restaurant in any part of town is that right?)
user: repeat that	 (bot: What kind of food would you like?)
user: no any area	 (bot: Did you say you are looking for a restaurant in the east of town?)
user: what about other areas	 (bot: api_call spanish R_location R_price)
user: need a restaurant serving brazilian food	 (bot: What part of town do you have in mind?)
user: what type of food does the venue serve	 (bot: da_vinci_pizzeria serves italian food)
user: i need a restaurant that serves corsica food	 (bot: I'm sorry but there is no restaurant serving corsica food)
user: persian	 (bot: I'm sorry but there is no restaurant serving persian food)
user: id like a restaurant in	 (bot: What part of town do you have in mind?)
user: cross over food	 (bot: I'm sorry but there is no restaurant serving crossover food)
user: the phone number for bloomsbury	 (bot: The phone number of bloomsbury_restaurant is bloomsbury_restaurant_phone)
user: im looking for scandinavian food	 (bot: What part of town do you have in mind?)
user: im done thank you	 (bot: mahal_of_cambridge is a great restaurant)
user: okay	 (bot: the_gandhi serves indian food in the cheap price range)
user: im looking for a restaurant	 (bot: What part of town do you have in mind?)
user: im looking for a restaurant in any area that	 (bot: What kind of food would you like?)
user: cuban food	 (bot: What part of town do you have in mind?)
user: ye	 (bot: the river bar steakhouse and grill is in the cheap price range)
user: cuban food	 (bot: api_call R_cuisine R_location cheap)
user: cuban food	 (bot: the_missing_sock is in the cheap price range)
user: cuban food	 (bot: la_margherita is in the cheap price range)
user: i want cuban food	 (bot: I'm sorry but there is no restaurant serving cuban food)
user: the addre	 (bot: Sure , the river bar steakhouse and grill is on the_river_bar_steakhouse_and_grill_address)
user: food	 (bot: What kind of food would you like?)
user: number	 (bot: Sorry but there is no other restaurant in the cheap price range and the south of town)
user: any type	 (bot: api_call R_cuisine west moderate)
user: thank you	 (bot: prezzo is a great restaurant)
user: are there any	 (bot: ali_baba is in the moderate price range)
user: any type	 (bot: api_call R_cuisine east expensive)
user: any type of food	 (bot: api_call R_cuisine south cheap)
user: yea	 (bot: api_call british R_location R_price)
user: thank you and price range	 (bot: the_varsity_restaurant is in the moderate price range)
user: part of town	 (bot: What part of town do you have in mind?)
user: nor	 (bot: Did you say you are looking for a restaurant in the north of town?)
user: okay ital	 (bot: I'm sorry but there is no seafood restaurant in the north of town)
user: thank you good	 (bot: I'm sorry but there is no seafood restaurant in the north of town)
user: thank you	 (bot: the_nirala is a great restaurant)
user: how about asian food	 (bot: I'm sorry but there is no restaurant serving swedish food)
user: can	 (bot: api_call R_cuisine R_location expensive)
user: no in any area	 (bot: I'm sorry but there is no mediterranean restaurant in the east of town)
user: a restaurant in	 (bot: Did you say you are looking for a restaurant in the east of town?)
user: catalan	 (bot: I'm sorry but there is no restaurant serving catalan food)
user: can i get the area	 (bot: frankie_and_bennys is a nice place in the south of town)
user: thank you	 (bot:  you are welcome)
user: asian	 (bot: I'm sorry but there is no restaurant serving corsica food)
user: can i have asian food	 (bot: You are looking for a corsica restaurant right?)
user: im looking for meditteranian	 (bot: You are looking for a modern_european restaurant right?)
user: modern europene	 (bot: darrys_cookhouse_and_wine_shop serves modern_european food in the expensive price range)
user: hi im looking for a restaurant	 (bot: What part of town do you have in mind?)
user: singaporean food	 (bot: api_call singaporean R_location R_price)
user: food	 (bot: I am sorry but there is no other korean restaurant that matches your request)
user: there	 (bot: little_seoul is a great restaurant)
user: okay thank you	 (bot: I am sorry but there is no other korean restaurant that matches your request)
user: yea	 (bot: What part of town do you have in mind?)
user: danish food	 (bot: I'm sorry but there is no restaurant serving english food)
user: um anything	 (bot: api_call R_cuisine east moderate)
user: could i have the address phone number and	 (bot: The phone number of the_hotpot is the_hotpot_phone)
user: how about in any area	 (bot: I'm sorry but there is no turkish restaurant in the north of town)
user: how about rest of town	 (bot: api_call turkish north R_price)
user: could i have the area please	 (bot: Sure , efes_restaurant is on efes_restaurant_address)
user: cuban	 (bot: I'm sorry but there is no restaurant serving cuban food)
user: um	 (bot: api_call chinese north R_price)
user: okay	 (bot: the_hotpot is a great restaurant)
user: thank you	 (bot: pizza_hut_fen_ditton is a great restaurant)
user: now	 (bot: Did you say you are looking for a restaurant in the west of town?)
user: now	 (bot: What kind of food would you like?)
user: now	 (bot: Did you say you are looking for a restaurant in the west of town?)
user: now	 (bot: Would you like something in the cheap , moderate , or expensive price range?)
user: where are they located	 (bot: anatolia is a great restaurant)
user: medterranean	 (bot: the_gardenia serves mediterranean food in the cheap price range)
user: again please	 (bot: the_nirala serves indian food in the moderate price range)
user: again please	 (bot: the_nirala serves indian food in the moderate price range)
user: thank	 (bot: curry_prince serves indian food in the moderate price range)
user: again	 (bot: meghna serves indian food in the moderate price range)
user: repeat	 (bot: rajmahal serves indian food in the moderate price range)
user: re	 (bot: rajmahal is a great restaurant)
user: repeat	 (bot: I am sorry but there is no other indian restaurant in the moderate price range)
user: thank	 (bot: the_nirala serves indian food in the moderate price range)
user: barbecue	 (bot:  you are welcome)
user: cant repeat	 (bot: rice_boat is a nice place in the west of town)
user: prezzo	 (bot: Sorry would you like creative or thai food?)
user: do you have prezzo	 (bot: I am sorry but there is no other thai restaurant in the west of town)
user: okay what was the name	 (bot: bangkok_city serves thai food)
user: on the rest and the	 (bot: Sure , bangkok_city is on bangkok_city_address)
user: phone number again	 (bot: The phone number of bangkok_city is bangkok_city_phone)
user: and price range	 (bot: bangkok_city is in the expensive price range)
user: okay um	 (bot: sala_thong serves thai food)
user: thank you and good	 (bot: sala_thong is a great restaurant)
user: anywhere	 (bot: Ok , a restaurant in any part of town is that right?)
user: corsica	 (bot: I'm sorry but there is no restaurant serving corsica food)
user: cough	 (bot: What part of town do you have in mind?)
user: cough	 (bot: I'm sorry but there is no restaurant serving christmas food)
user: cough	 (bot: api_call indian R_location cheap)
user: thank you	 (bot: taj_tandoori is a great restaurant)
user: that is all	 (bot: Sorry but there is no other indian restaurant in the expensive price range and the south of town)
user: thank you goodb	 (bot:  you are welcome)
user: okay	 (bot: I'm sorry but there is no restaurant serving cheap european food)
user: what	 (bot: You are looking for a european restaurant right?)
user: okay	 (bot: I'm sorry but there is no restaurant serving cheap european food)
user: thank you	 (bot: nandos_city_centre is a great restaurant)
user: perfect	 (bot: nandos serves portuguese food in the cheap price range)
user: thank you	 (bot: nandos is a great restaurant)
user: i am looking for persian food please	 (bot: You are looking for a persian restaurant right?)
user: how about	 (bot: I'm sorry but there is no restaurant serving persian food)
user: where is the location	 (bot: kymmoy is a great restaurant)
user: thank you	 (bot: kymmoy is a great restaurant)
user: what food is available	 (bot: api_call R_cuisine north cheap)
user: hindi food is okay	 (bot: Would you like something in the cheap , moderate , or expensive price range?)
user: where is one	 (bot: api_call international R_location R_price)
user: is doesnt matter	 (bot: api_call chinese south R_price)
user: can i have an	 (bot: What part of town do you have in mind?)
user: right	 (bot: api_call english R_location R_price)
user: thank you	 (bot: saint_johns_chop_house is a great restaurant)
user: thank you	 (bot: thanh_binh is a great restaurant)
user: how about india	 (bot: I'm sorry but there is no restaurant serving singaporean food)
user: any food	 (bot: Would you like something in the cheap , moderate , or expensive price range?)
user: im looking for a restaurant that has	 (bot: What part of town do you have in mind?)
user: right	 (bot: api_call turkish R_location R_price)
user: any thing else	 (bot: meghna is a nice place in the north of town and the prices are moderate)
user: code	 (bot: pizza_hut_cherry_hinton is a nice place in the south of town and the prices are moderate)
user: what type of venue	 (bot: royal_spice serves indian food)
user: dont matter	 (bot: Would you like something in the cheap , moderate , or expensive price range?)
user: cough	 (bot: I'm sorry but there is no british restaurant in the south of town)
user: cough	 (bot: Did you say you are looking for a restaurant in the south of town?)
user: type food	 (bot: You are looking for a thai restaurant right?)
user: yeah	 (bot: You are looking for a vietnamese restaurant right?)
user: that serves viet	 (bot: api_call vietnamese west R_price)
user: im looking for a restaurant serving	 (bot: I'm sorry but there is no restaurant serving kosher food)
user: any type is fine	 (bot: api_call R_cuisine R_location moderate)
user: yeah	 (bot: api_call R_cuisine south moderate)
user: any any part of town	 (bot: What kind of food would you like?)
user: any type	 (bot: What part of town do you have in mind?)
user: what area of town is it	 (bot: cote is a nice place in the centre of town)
user: thank you	 (bot: da_vinci_pizzeria is a great restaurant)
user: food do they serve	 (bot: royal_spice is in the cheap price range)
user: thank you	 (bot: golden_wok is a nice place in the north of town and the prices are moderate)
user: restaurant	 (bot: What part of town do you have in mind?)
user: corsica food	 (bot: I'm sorry but there is no restaurant serving corsica food)
user: scottish	 (bot: What kind of food would you like?)
user: scottish	 (bot: I'm sorry but there is no restaurant serving scottish food)
user: system	 (bot: What part of town do you have in mind?)
user: hello welcome to the cambridge system	 (bot: What part of town do you have in mind?)
user: any type	 (bot: api_call R_cuisine east expensive)
user: basque	 (bot: You are looking for a basque restaurant right?)
user: um hm	 (bot: Sorry would you like something in the north or in the east)
user: whats the addre	 (bot: Sure , thanh_binh is on thanh_binh_address)
user: im looking for cuban food	 (bot: I'm sorry but there is no restaurant serving cuban food)
user: no price	 (bot: saigon_city is a great restaurant)
user: expen	 (bot: What kind of food would you like?)
user: than	 (bot: frankie_and_bennys is a great restaurant)
user: im looking for a restaurant that serves scottish food	 (bot: You are looking for a scottish restaurant right?)
user: food	 (bot: What part of town do you have in mind?)
user: what type of food is that	 (bot: sitar_tandoori serves indian food)
user: and what area	 (bot: galleria is a nice place in the centre of town)
user: im looking for a restaurant in any area that serves	 (bot: Ok , a restaurant in any part of town is that right?)
user: im sorry	 (bot: What kind of food would you like?)
user: could you repeat that	 (bot: You are looking for a spanish restaurant right?)
user: ok yeah	 (bot: api_call spanish R_location R_price)
user: whats the addre	 (bot: la_raza is a great restaurant)
user: russian	 (bot: kohinoor is in the cheap price range)
user: type of food does pizza_hut serve	 (bot: pizza_hut_fen_ditton serves italian food)
user: okay let me try this again	 (bot: What part of town do you have in mind?)
user: whats the address to that please	 (bot: Sure , nandos_city_centre is on nandos_city_centre_address)
user: i need	 (bot: the_missing_sock is a nice place in the east of town)
user: i need a restaurant that	 (bot: I'm sorry but there is no spanish restaurant in the east of town)
user: whats the area	 (bot: curry_garden is a nice place in the centre of town)
user: whats the type of food	 (bot: rajmahal serves indian food)
user: indonesian	 (bot: I'm sorry but there is no restaurant serving indonesian food)
user: what kind of food is it	 (bot: pizza_hut_fen_ditton serves italian food)
user: what type of food is there	 (bot: the_nirala serves indian food)
user: any kind of food	 (bot: api_call R_cuisine west cheap)
user: any kind of food	 (bot: api_call R_cuisine west cheap)
user: um	 (bot: grafton_hotel_restaurant is a nice place in the east of town and the prices are expensive)
user: how about a different restaurant	 (bot: yu_garden is a nice place in the east of town and the prices are expensive)
user: restaurant	 (bot: What part of town do you have in mind?)
user: do they serve food	 (bot: the_gandhi is a great restaurant)
user: how about	 (bot: rice_house is in the cheap price range)
user: what does rice_house	 (bot: rice_house is a great restaurant)
user: serve	 (bot: ask is in the cheap price range)
user: i do not care	 (bot: api_call R_cuisine north moderate)
user: belgium	 (bot: What kind of food would you like?)
user: belgium	 (bot: You are looking for a restaurant serving any kind of food right?)
user: belgium food	 (bot: I'm sorry but there is no restaurant serving belgian food)
user: hi im looking for a restaurant in the	 (bot: What part of town do you have in mind?)
user: is there a restaurant	 (bot: da_vinci_pizzeria is a great restaurant)
user: hi im looking for a place that serves scandinavian food	 (bot: What part of town do you have in mind?)
user: scandinavian	 (bot: Would you like something in the cheap , moderate , or expensive price range?)
user: restaurant with scandin	 (bot: Can I help you with anything else?)
user: ye	 (bot: You are looking for a scandinavian restaurant right?)
user: what is the addre	 (bot: Sure , bangkok_city is on bangkok_city_address)
user: thank you	 (bot: sitar_tandoori is a nice place in the east of town and the prices are expensive)
user: i want a russian restaurant	 (bot: I'm sorry but there is no restaurant serving russian food)
user: how about	 (bot: I'm sorry but there is no restaurant serving irish food)
user: im looking for a restaurant in any area	 (bot: What part of town do you have in mind?)
user: jamaican	 (bot: What kind of food would you like?)
user: what about chineese	 (bot: I'm sorry but there is no restaurant serving cuban food)
user: persian	 (bot: api_call persian R_location moderate)
user: what kind of food is it	 (bot: cotto serves british food)
user: what about persian food	 (bot: restaurant_one_seven is in the moderate price range)
user: hi	 (bot: I am sorry but there is no other vietnamese restaurant that matches your request)
user: um	 (bot: What part of town do you have in mind?)
user: no any area	 (bot: Sorry would you like the east of town or you dont care)
user: can i okay thank you	 (bot: thanh_binh is a great restaurant)
user: can i get a	 (bot: golden_wok is a great restaurant)
user: yes danish food	 (bot: You are looking for a english restaurant right?)
user: no danish	 (bot: I'm sorry but there is no restaurant serving english food)
user: danish	 (bot: api_call R_cuisine R_location expensive)
user: danish	 (bot: Sure , bedouin is on bedouin_address)
user: venetian food	 (bot: I'm sorry but there is no restaurant serving venetian food)
user: food	 (bot: api_call asian_oriental R_location R_price)
user: cough	 (bot: Sorry I am a bit confused ; please tell me again what you are looking for .)
user: may i	 (bot: j_restaurant is a great restaurant)
user: thank you	 (bot: sala_thong is a great restaurant)
user: yeah can i um	 (bot: What part of town do you have in mind?)
user: what kind of food	 (bot: the_copper_kettle serves british food)
user: okay how about any area	 (bot: I'm sorry but there is no mediterranean restaurant in the north of town)
user: okay how about any part of town	 (bot: api_call mediterranean north R_price)
user: ah scottish food	 (bot: I'm sorry but there is no restaurant serving scottish food)
user: kay and ah where is it located	 (bot: chiquito_restaurant_bar is a great restaurant)
user: okay and ah wheres it located	 (bot: The post code of chiquito_restaurant_bar is chiquito_restaurant_bar_post_code)
user: okay and whats the addre	 (bot: Sure , chiquito_restaurant_bar is on chiquito_restaurant_bar_address)
user: kay	 (bot: I am sorry but there is no other french restaurant in the centre of town)
user: okay and ah	 (bot: cote is a great restaurant)
user: what the addre	 (bot: Sure , cote is on cote_address)
user: kay	 (bot: I am sorry but there is no other french restaurant in the centre of town)
user: and ah	 (bot: restaurant_two_two serves french food)
user: kay	 (bot: Did you say you are looking for a restaurant in the centre of town?)
user: whats his addre	 (bot: Sure , restaurant_two_two is on restaurant_two_two_address)
user: kay um	 (bot: restaurant_two_two is a great restaurant)
user: ah yes im looking for persian food though	 (bot: What kind of food would you like?)
user: ah yes	 (bot: You are looking for a persian restaurant right?)
user: a restaurant	 (bot: What part of town do you have in mind?)
user: okay	 (bot: I am sorry but there is no other mexican restaurant that matches your request)
user: taquita restaurant	 (bot: chiquito_restaurant_bar serves mexican food)
user: thank you	 (bot: chiquito_restaurant_bar is a great restaurant)
user: catalan food	 (bot: What part of town do you have in mind?)
user: venetian	 (bot: I'm sorry but there is no restaurant serving venetian food)
user: right	 (bot: the good luck chinese food takeaway is a nice place in the south of town serving tasty chinese food)
user: im looking	 (bot: Ok , a restaurant in any part of town is that right?)
user: how about asian food	 (bot: api_call R_cuisine north R_price)
user: cough	 (bot: Sorry, I can't hear you)
user: thats fine	 (bot: saint_johns_chop_house is a nice place in the west of town and the prices are moderate)
user: i want to know	 (bot: prezzo is a nice place in the west of town and the prices are moderate)
user: eritrean food	 (bot: Sorry would you like vietnamese food or you dont care)
user: i dont know	 (bot: api_call R_cuisine east moderate)
user: food	 (bot: grafton_hotel_restaurant is a nice place in the east of town and the prices are expensive)
user: type of food served	 (bot: grafton_hotel_restaurant serves british food)
user: thank you	 (bot: grafton_hotel_restaurant is a great restaurant)
user: corsica food	 (bot: I'm sorry but there is no restaurant serving corsica food)
user: im looking for	 (bot: What part of town do you have in mind?)
user: sea food	 (bot: What kind of food would you like?)
user: sea food	 (bot: api_call chinese R_location R_price)
user: sea food	 (bot: loch_fyne is a great restaurant)
user: the adra	 (bot: Sure , la_raza is on la_raza_address)
user: any food	 (bot: api_call R_cuisine R_location expensive)
user: anything house	 (bot: chiquito_restaurant_bar is a nice place in the south of town and the prices are expensive)
user: im looking for food	 (bot: What part of town do you have in mind?)
user: uh i dont mind	 (bot: api_call R_cuisine north cheap)
user: okay is there another option	 (bot: da_vinci_pizzeria is a nice place in the north of town and the prices are cheap)
user: correct	 (bot: What part of town do you have in mind?)
user: whats the phone number there	 (bot: The phone number of curry_prince is curry_prince_phone)
user: and what type of food is that	 (bot: curry_prince serves indian food)
user: uh	 (bot: la_raza is a great restaurant)
user: and	 (bot: Sorry but there is no other restaurant in the cheap price range and the south of town)
user: uh no preference	 (bot: api_call R_cuisine north moderate)
user: thank you	 (bot: meghna is a great restaurant)
user: sea food	 (bot: I'm sorry but there is no restaurant serving cheap seafood food)
user: whats the signature dish	 (bot: la_raza is in the cheap price range)
user: what is the signature dish	 (bot: la_raza is a great restaurant)
user: i am looking fora restaurant that should serve	 (bot: What part of town do you have in mind?)
